Id_Dep,Id_Mun,Departamento,Municipio,Población,Población Hombres,% Hombres,Población Mujeres,% Mujeres,Pob. Urbana,% Pobl. Urbana,Pob. Rural,% Pobl. Rural,Pobl. Pueblo Orig,% Pobl. Pueblos Orig
1,101,Guatemala,Guatemala,923392,438695,47.5 %,484697,52.5 %,923392,100.0 %,0,0.0 %,70511,7.6 %
1,102,Guatemala,Santa Catarina Pinula,80582,38174,47.4 %,42408,52.6 %,70982,88.1 %,9600,11.9 %,3318,4.1 %
1,103,Guatemala,San José Pinula,79844,38661,48.4 %,41183,51.6 %,67327,84.3 %,12517,15.7 %,3404,4.3 %
1,104,Guatemala,San José del Golfo,7229,3493,48.3 %,3736,51.7 %,2331,32.2 %,4898,67.8 %,156,2.2 %
1,105,Guatemala,Palencia,70973,34608,48.8 %,36365,51.2 %,31824,44.8 %,39149,55.2 %,1481,2.1 %
1,106,Guatemala,Chinautla,114752,55265,48.2 %,59487,51.8 %,104972,91.5 %,9780,8.5 %,20527,17.9 %
1,107,Guatemala,San Pedro Ayampuc,58609,28578,48.8 %,30031,51.2 %,48727,83.1 %,9882,16.9 %,14891,25.4 %
1,108,Guatemala,Mixco,465773,221110,47.5 %,244663,52.5 %,463019,99.4 %,2754,0.6 %,45966,9.9 %
1,109,Guatemala,San Pedro Sacatepéquez,51292,25149,49.0 %,26143,51.0 %,36932,72.0 %,14360,28.0 %,39205,76.4 %
1,110,Guatemala,San Juan Sacatepéquez,218156,106748,48.9 %,111408,51.1 %,155965,71.5 %,62191,28.5 %,138658,63.6 %
1,111,Guatemala,San Raimundo,31605,15019,47.5 %,16586,52.5 %,15447,48.9 %,16158,51.1 %,22573,71.4 %
1,112,Guatemala,Chuarrancho,12638,6326,50.1 %,6312,49.9 %,7634,60.4 %,5004,39.6 %,10915,86.4 %
1,113,Guatemala,Fraijanes,58922,30496,51.8 %,28426,48.2 %,44117,74.9 %,14805,25.1 %,2976,5.1 %
1,114,Guatemala,Amatitlán,116711,56846,48.7 %,59865,51.3 %,98176,84.1 %,18535,15.9 %,4624,4.0 %
1,115,Guatemala,Villa Nueva,433734,208914,48.2 %,224820,51.8 %,426316,98.3 %,7418,1.7 %,23760,5.5 %
1,116,Guatemala,Villa Canales,155422,75968,48.9 %,79454,51.1 %,124680,80.2 %,30742,19.8 %,5311,3.4 %
1,117,Guatemala,Petapa,135447,65153,48.1 %,70294,51.9 %,129124,95.3 %,6323,4.7 %,8287,6.1 %
2,201,El Progreso,Guastatoya,24821,12206,49.2 %,12615,50.8 %,24821,100.0 %,0,0.0 %,669,2.7 %
2,202,El Progreso,Morazán,12164,6008,49.4 %,6156,50.6 %,2581,21.2 %,9583,78.8 %,169,1.4 %
2,203,El Progreso,San Agustín Acasaguastlán,45765,22760,49.7 %,23005,50.3 %,17728,38.7 %,28037,61.3 %,648,1.4 %
2,204,El Progreso,San Cristóbal Acasaguastlán,7199,3459,48.0 %,3740,52.0 %,2329,32.4 %,4870,67.6 %,81,1.1 %
2,205,El Progreso,El Jícaro,13128,6474,49.3 %,6654,50.7 %,6911,52.6 %,6217,47.4 %,85,0.6 %
2,206,El Progreso,Sanarate,13154,6488,49.3 %,6666,50.7 %,4727,35.9 %,8427,64.1 %,189,1.4 %
2,207,El Progreso,Sansare,39444,19274,48.9 %,20170,51.1 %,20976,53.2 %,18468,46.8 %,635,1.6 %
2,208,El Progreso,San Antonio La Paz,20957,10503,50.1 %,10454,49.9 %,11343,54.1 %,9614,45.9 %,467,2.2 %
3,301,Sacatepéquez,Antigua Guatemala,46054,22403,48.6 %,23651,51.4 %,46054,100.0 %,0,0.0 %,5282,11.5 %
3,302,Sacatepéquez,Jocotenango,21657,10419,48.1 %,11238,51.9 %,19280,89.0 %,2377,11.0 %,1695,7.8 %
3,303,Sacatepéquez,Pastores,17814,8725,49.0 %,9089,51.0 %,12621,70.8 %,5193,29.2 %,1378,7.7 %
3,304,Sacatepéquez,Sumpango,37260,18398,49.4 %,18862,50.6 %,28488,76.5 %,8772,23.5 %,33766,90.6 %
3,305,Sacatepéquez,Santo Domingo Xenacoj,12402,5995,48.3 %,6407,51.7 %,10632,85.7 %,1770,14.3 %,10886,87.8 %
3,306,Sacatepéquez,Santiago Sacatepéquez,29238,14305,48.9 %,14933,51.1 %,24100,82.4 %,5138,17.6 %,24172,82.7 %
3,307,Sacatepéquez,San Bartolomé Milpas Altas,7816,3712,47.5 %,4104,52.5 %,7816,100.0 %,0,0.0 %,2348,30.0 %
3,308,Sacatepéquez,San Lucas Sacatepéquez,23369,11099,47.5 %,12270,52.5 %,20723,88.7 %,2646,11.3 %,2434,10.4 %
3,309,Sacatepéquez,Santa Lucía Milpas Altas,15570,7586,48.7 %,7984,51.3 %,12234,78.6 %,3336,21.4 %,871,5.6 %
3,310,Sacatepéquez,Magdalena Milpas Altas,11856,5886,49.6 %,5970,50.4 %,7841,66.1 %,4015,33.9 %,3253,27.4 %
3,311,Sacatepéquez,Santa María de Jesús,21938,11143,50.8 %,10795,49.2 %,21795,99.3 %,143,0.7 %,21576,98.3 %
3,312,Sacatepéquez,Ciudad Vieja,33405,16443,49.2 %,16962,50.8 %,32802,98.2 %,603,1.8 %,857,2.6 %
3,313,Sacatepéquez,San Miguel Dueñas,12696,6191,48.8 %,6505,51.2 %,10892,85.8 %,1804,14.2 %,936,7.4 %
3,314,Sacatepéquez,Alotenango,23986,11855,49.4 %,12131,50.6 %,23358,97.4 %,628,2.6 %,10747,44.8 %
3,315,Sacatepéquez,San Antonio Aguas Calientes,11347,5527,48.7 %,5820,51.3 %,9669,85.2 %,1678,14.8 %,10025,88.3 %
3,316,Sacatepéquez,Santa Catarina Barahona,4061,2004,49.3 %,2057,50.7 %,4061,100.0 %,0,0.0 %,3656,90.0 %
4,401,Chimaltenango,Chimaltenango,96985,46985,48.4 %,50000,51.6 %,96985,100.0 %,0,0.0 %,62107,64.0 %
4,402,Chimaltenango,San José Poaquil,26845,12633,47.1 %,14212,52.9 %,9726,36.2 %,17119,63.8 %,25881,96.4 %
4,403,Chimaltenango,San Martín Jilotepeque,73469,34461,46.9 %,39008,53.1 %,10812,14.7 %,62657,85.3 %,65541,89.2 %
4,404,Chimaltenango,Comalapa,48597,23615,48.6 %,24982,51.4 %,32312,66.5 %,16285,33.5 %,47302,97.3 %
4,405,Chimaltenango,Santa Apolonia,18540,8847,47.7 %,9693,52.3 %,2314,12.5 %,16226,87.5 %,17213,92.8 %
4,406,Chimaltenango,Tecpán Guatemala,91927,44291,48.2 %,47636,51.8 %,34519,37.6 %,57408,62.4 %,85240,92.7 %
4,407,Chimaltenango,Patzún,58240,28185,48.4 %,30055,51.6 %,26632,45.7 %,31608,54.3 %,55487,95.3 %
4,408,Chimaltenango,Pochuta,8790,4350,49.5 %,4440,50.5 %,4272,48.6 %,4518,51.4 %,2438,27.7 %
4,409,Chimaltenango,Patzicía,33207,16107,48.5 %,17100,51.5 %,21249,64.0 %,11958,36.0 %,30039,90.5 %
4,410,Chimaltenango,Santa Cruz Balanyá,9479,4644,49.0 %,4835,51.0 %,1545,16.3 %,7934,83.7 %,9136,96.4 %
4,411,Chimaltenango,Acatenango,23228,11212,48.3 %,12016,51.7 %,12136,52.2 %,11092,47.8 %,15328,66.0 %
4,412,Chimaltenango,Yepocapa,34948,17567,50.3 %,17381,49.7 %,17021,48.7 %,17927,51.3 %,22537,64.5 %
4,413,Chimaltenango,San Andrés Itzapa,32083,15552,48.5 %,16531,51.5 %,24992,77.9 %,7091,22.1 %,23131,72.1 %
4,414,Chimaltenango,Parramos,15924,7640,48.0 %,8284,52.0 %,11970,75.2 %,3954,24.8 %,8106,50.9 %
4,415,Chimaltenango,Zaragoza,24022,11643,48.5 %,12379,51.5 %,11176,46.5 %,12846,53.5 %,7370,30.7 %
4,416,Chimaltenango,El Tejar,19492,9422,48.3 %,10070,51.7 %,15639,80.2 %,3853,19.8 %,6534,33.5 %
5,501,Escuintla,Escuintla,156313,78365,50.1 %,77948,49.9 %,156313,100.0 %,0,0.0 %,6233,4.0 %
5,502,Escuintla,Santa Lucía Cotzumalguapa,112780,56258,49.9 %,56522,50.1 %,58877,52.2 %,53903,47.8 %,4425,3.9 %
5,503,Escuintla,La Democracia,23017,11491,49.9 %,11526,50.1 %,13400,58.2 %,9617,41.8 %,670,2.9 %
5,504,Escuintla,Siquinalá,22968,11543,50.3 %,11425,49.7 %,18150,79.0 %,4818,21.0 %,1595,6.9 %
5,505,Escuintla,Masagua,45323,22701,50.1 %,22622,49.9 %,16797,37.1 %,28526,62.9 %,1301,2.9 %
5,506,Escuintla,Tiquisate,57292,28423,49.6 %,28869,50.4 %,29193,51.0 %,28099,49.0 %,1979,3.5 %
5,507,Escuintla,La Gomera,46666,23493,50.3 %,23173,49.7 %,26533,56.9 %,20133,43.1 %,1492,3.2 %
5,508,Escuintla,Guanagazapa,15958,8115,50.9 %,7843,49.1 %,3738,23.4 %,12220,76.6 %,2839,17.8 %
5,509,Escuintla,San José,62801,31246,49.8 %,31555,50.2 %,23887,38.0 %,38914,62.0 %,2159,3.4 %
5,510,Escuintla,Iztapa,18342,9173,50.0 %,9169,50.0 %,4900,26.7 %,13442,73.3 %,316,1.7 %
5,511,Escuintla,Palín,65873,32261,49.0 %,33612,51.0 %,62095,94.3 %,3778,5.7 %,14140,21.5 %
5,512,Escuintla,San Vicente Pacaya,16705,8346,50.0 %,8359,50.0 %,8942,53.5 %,7763,46.5 %,831,5.0 %
5,513,Escuintla,Nueva Concepción,72909,35953,49.3 %,36956,50.7 %,15747,21.6 %,57162,78.4 %,1364,1.9 %
5,514,Escuintla,Sipacate,16234,8139,50.1 %,8095,49.9 %,9959,61.3 %,6275,38.7 %,414,2.6 %
6,601,Santa Rosa,Cuilapa,41359,20524,49.6 %,20835,50.4 %,41359,100.0 %,0,0.0 %,2757,6.7 %
6,602,Santa Rosa,Barberena,58276,28398,48.7 %,29878,51.3 %,47093,80.8 %,11183,19.2 %,2242,3.8 %
6,603,Santa Rosa,Santa Rosa de Lima,19702,9518,48.3 %,10184,51.7 %,3596,18.3 %,16106,81.7 %,5584,28.3 %
6,604,Santa Rosa,Casillas,24956,12023,48.2 %,12933,51.8 %,7698,30.8 %,17258,69.2 %,14545,58.3 %
6,605,Santa Rosa,San Rafael Las Flores,12641,6249,49.4 %,6392,50.6 %,3610,28.6 %,9031,71.4 %,3350,26.5 %
6,606,Santa Rosa,Oratorio,24954,12296,49.3 %,12658,50.7 %,10068,40.3 %,14886,59.7 %,802,3.2 %
6,607,Santa Rosa,San Juan Tecuaco,10122,5100,50.4 %,5022,49.6 %,2966,29.3 %,7156,70.7 %,3698,36.5 %
6,608,Santa Rosa,Chiquimulilla,53727,26480,49.3 %,27247,50.7 %,18848,35.1 %,34879,64.9 %,4196,7.8 %
6,609,Santa Rosa,Taxisco,29846,15047,50.4 %,14799,49.6 %,9130,30.6 %,20716,69.4 %,1152,3.9 %
6,610,Santa Rosa,Santa María Ixhuatán,23801,11803,49.6 %,11998,50.4 %,4619,19.4 %,19182,80.6 %,2153,9.0 %
6,611,Santa Rosa,Guazacapán,18855,9354,49.6 %,9501,50.4 %,12195,64.7 %,6660,35.3 %,4580,24.3 %
6,612,Santa Rosa,Santa Cruz Naranjo,16385,8159,49.8 %,8226,50.2 %,5768,35.2 %,10617,64.8 %,1389,8.5 %
6,613,Santa Rosa,Pueblo Nuevo Viñas,25529,12972,50.8 %,12557,49.2 %,3727,14.6 %,21802,85.4 %,697,2.7 %
6,614,Santa Rosa,Nueva Santa Rosa,36454,17661,48.4 %,18793,51.6 %,13535,37.1 %,22919,62.9 %,18104,49.7 %
7,701,Sololá,Sololá,88612,42261,47.7 %,46351,52.3 %,88612,100.0 %,0,0.0 %,83879,94.7 %
7,702,Sololá,San José Chacayá,4068,1950,47.9 %,2118,52.1 %,1013,24.9 %,3055,75.1 %,3931,96.6 %
7,703,Sololá,Santa María Visitación,2370,1155,48.7 %,1215,51.3 %,1579,66.6 %,791,33.4 %,2327,98.2 %
7,704,Sololá,Santa Lucía Utatlán,21284,9931,46.7 %,11353,53.3 %,1356,6.4 %,19928,93.6 %,20709,97.3 %
7,705,Sololá,Nahualá,75430,35401,46.9 %,40029,53.1 %,23635,31.3 %,51795,68.7 %,75344,99.9 %
7,706,Sololá,Santa Catarina Ixtahuacán,56981,26490,46.5 %,30491,53.5 %,19560,34.3 %,37421,65.7 %,56867,99.8 %
7,707,Sololá,Santa Clara La Laguna,9405,4555,48.4 %,4850,51.6 %,6707,71.3 %,2698,28.7 %,9301,98.9 %
7,708,Sololá,Concepción,6601,3171,48.0 %,3430,52.0 %,4024,61.0 %,2577,39.0 %,6589,99.8 %
7,709,Sololá,San Andrés Semetabaj,13142,6114,46.5 %,7028,53.5 %,3325,25.3 %,9817,74.7 %,12226,93.0 %
7,710,Sololá,Panajachel,15077,7269,48.2 %,7808,51.8 %,13767,91.3 %,1310,8.7 %,11537,76.5 %
7,711,Sololá,Santa Catarina Palopó,3924,1930,49.2 %,1994,50.8 %,3297,84.0 %,627,16.0 %,3914,99.7 %
7,712,Sololá,San Antonio Palopó,14437,6754,46.8 %,7683,53.2 %,7062,48.9 %,7375,51.1 %,13691,94.8 %
7,713,Sololá,San Lucas Tolimán,29772,14723,49.5 %,15049,50.5 %,17101,57.4 %,12671,42.6 %,27758,93.2 %
7,714,Sololá,Santa Cruz La Laguna,5820,2850,49.0 %,2970,51.0 %,1723,29.6 %,4097,70.4 %,5792,99.5 %
7,715,Sololá,San Pablo La Laguna,7299,3638,49.8 %,3661,50.2 %,7299,100.0 %,0,0.0 %,7289,99.9 %
7,716,Sololá,San Marcos La Laguna,2617,1253,47.9 %,1364,52.1 %,2617,100.0 %,0,0.0 %,2549,97.4 %
7,717,Sololá,San Juan La Laguna,12162,6043,49.7 %,6119,50.3 %,8051,66.2 %,4111,33.8 %,12039,99.0 %
7,718,Sololá,San Pedro La Laguna,10705,5202,48.6 %,5503,51.4 %,10705,100.0 %,0,0.0 %,10425,97.4 %
7,719,Sololá,Santiago Atitlán,41877,20575,49.1 %,21302,50.9 %,38100,91.0 %,3777,9.0 %,40916,97.7 %
8,801,Totonicapán,Totonicapán,103952,47890,46.1 %,56062,53.9 %,103952,100.0 %,0,0.0 %,101077,97.2 %
8,802,Totonicapán,San Cristóbal Totonicapán,36119,16808,46.5 %,19311,53.5 %,12589,34.9 %,23530,65.1 %,33704,93.3 %
8,803,Totonicapán,San Francisco El Alto,57894,27109,46.8 %,30785,53.2 %,38995,67.4 %,18899,32.6 %,57243,98.9 %
8,804,Totonicapán,San Andrés Xecul,26984,12430,46.1 %,14554,53.9 %,15074,55.9 %,11910,44.1 %,26695,98.9 %
8,805,Totonicapán,Momostenango,105617,50031,47.4 %,55586,52.6 %,15601,14.8 %,90016,85.2 %,104526,99.0 %
8,806,Totonicapán,Santa María Chiquimula,55013,26349,47.9 %,28664,52.1 %,15919,28.9 %,39094,71.1 %,54897,99.8 %
8,807,Totonicapán,Santa Lucía La Reforma,22378,10727,47.9 %,11651,52.1 %,1146,5.1 %,21232,94.9 %,22315,99.7 %
8,808,Totonicapán,San Bartolo,10612,4949,46.6 %,5663,53.4 %,1662,15.7 %,8950,84.3 %,10442,98.4 %
9,901,Quetzaltenango,Quetzaltenango,180706,85644,47.4 %,95062,52.6 %,180706,100.0 %,0,0.0 %,84858,47.0 %
9,902,Quetzaltenango,Salcajá,19434,9207,47.4 %,10227,52.6 %,17042,87.7 %,2392,12.3 %,7195,37.0 %
9,903,Quetzaltenango,Olintepeque,35060,16364,46.7 %,18696,53.3 %,31545,90.0 %,3515,10.0 %,26302,75.0 %
9,904,Quetzaltenango,San Carlos Sija,30224,14221,47.1 %,16003,52.9 %,4766,15.8 %,25458,84.2 %,12745,42.2 %
9,905,Quetzaltenango,Sibilia,8407,3996,47.5 %,4411,52.5 %,830,9.9 %,7577,90.1 %,654,7.8 %
9,906,Quetzaltenango,Cabricán,23033,10427,45.3 %,12606,54.7 %,6998,30.4 %,16035,69.6 %,18887,82.0 %
9,907,Quetzaltenango,Cajolá,14948,6344,42.4 %,8604,57.6 %,14948,100.0 %,0,0.0 %,14344,96.0 %
9,908,Quetzaltenango,San Miguel Sigüila,7889,3395,43.0 %,4494,57.0 %,4662,59.1 %,3227,40.9 %,7551,95.7 %
9,909,Quetzaltenango,San Juan Ostuncalco,51828,23475,45.3 %,28353,54.7 %,20763,40.1 %,31065,59.9 %,44441,85.7 %
9,910,Quetzaltenango,San Mateo,7895,3758,47.6 %,4137,52.4 %,7719,97.8 %,176,2.2 %,2479,31.4 %
9,911,Quetzaltenango,Concepción Chiquirichapa,17342,7838,45.2 %,9504,54.8 %,9879,57.0 %,7463,43.0 %,17186,99.1 %
9,912,Quetzaltenango,San Martín Sacatepéquez,29373,13373,45.5 %,16000,54.5 %,4457,15.2 %,24916,84.8 %,26552,90.4 %
9,913,Quetzaltenango,Almolonga,15724,7182,45.7 %,8542,54.3 %,12299,78.2 %,3425,21.8 %,15527,98.7 %
9,914,Quetzaltenango,Cantel,42142,21383,50.7 %,20759,49.3 %,35825,85.0 %,6317,15.0 %,38619,91.6 %
9,915,Quetzaltenango,Huitán,13450,5964,44.3 %,7486,55.7 %,4707,35.0 %,8743,65.0 %,12652,94.1 %
9,916,Quetzaltenango,Zunil,14118,6381,45.2 %,7737,54.8 %,10792,76.4 %,3326,23.6 %,11755,83.3 %
9,917,Quetzaltenango,Colomba,47544,23477,49.4 %,24067,50.6 %,28655,60.3 %,18889,39.7 %,1333,2.8 %
9,918,Quetzaltenango,San Francisco La Unión,7939,3591,45.2 %,4348,54.8 %,3375,42.5 %,4564,57.5 %,7870,99.1 %
9,919,Quetzaltenango,El Palmar,29132,14230,48.8 %,14902,51.2 %,19115,65.6 %,10017,34.4 %,19576,67.2 %
9,920,Quetzaltenango,Coatepeque,105415,51087,48.5 %,54328,51.5 %,37330,35.4 %,68085,64.6 %,2599,2.5 %
9,921,Quetzaltenango,Génova,37497,17981,48.0 %,19516,52.0 %,4731,12.6 %,32766,87.4 %,10379,27.7 %
9,922,Quetzaltenango,Flores Costa Cuca,21630,10677,49.4 %,10953,50.6 %,9008,41.6 %,12622,58.4 %,873,4.0 %
9,923,Quetzaltenango,La Esperanza,22166,10508,47.4 %,11658,52.6 %,19724,89.0 %,2442,11.0 %,12227,55.2 %
9,924,Quetzaltenango,Palestina de Los Altos,16205,7279,44.9 %,8926,55.1 %,1958,12.1 %,14247,87.9 %,11965,73.8 %
10,1001,Suchitepéquez,Mazatenango,77431,37643,48.6 %,39788,51.4 %,77431,100.0 %,0,0.0 %,11161,14.4 %
10,1002,Suchitepéquez,Cuyotenango,33436,16366,48.9 %,17070,51.1 %,8332,24.9 %,25104,75.1 %,7653,22.9 %
10,1003,Suchitepéquez,San Francisco Zapotitlán,22533,10992,48.8 %,11541,51.2 %,18468,82.0 %,4065,18.0 %,1343,6.0 %
10,1004,Suchitepéquez,San Bernardino,15849,7703,48.6 %,8146,51.4 %,3961,25.0 %,11888,75.0 %,10519,66.4 %
10,1005,Suchitepéquez,San José El Ídolo,10212,4976,48.7 %,5236,51.3 %,3049,29.9 %,7163,70.1 %,1954,19.1 %
10,1006,Suchitepéquez,Santo Domingo Suchitepéquez,42291,20653,48.8 %,21638,51.2 %,7578,17.9 %,34713,82.1 %,11458,27.1 %
10,1007,Suchitepéquez,San Lorenzo,13282,6468,48.7 %,6814,51.3 %,4663,35.1 %,8619,64.9 %,8516,64.1 %
10,1008,Suchitepéquez,Samayac,24790,12085,48.7 %,12705,51.3 %,9681,39.1 %,15109,60.9 %,20727,83.6 %
10,1009,Suchitepéquez,San Pablo Jocopilas,20433,9758,47.8 %,10675,52.2 %,16872,82.6 %,3561,17.4 %,16033,78.5 %
10,1010,Suchitepéquez,San Antonio Suchitepéquez,59184,29259,49.4 %,29925,50.6 %,13666,23.1 %,45518,76.9 %,34532,58.3 %
10,1011,Suchitepéquez,San Miguel Panán,10320,5067,49.1 %,5253,50.9 %,4885,47.3 %,5435,52.7 %,8436,81.7 %
10,1012,Suchitepéquez,San Gabriel,7383,3602,48.8 %,3781,51.2 %,6599,89.4 %,784,10.6 %,3439,46.6 %
10,1013,Suchitepéquez,Chicacao,60735,30119,49.6 %,30616,50.4 %,26309,43.3 %,34426,56.7 %,42716,70.3 %
10,1014,Suchitepéquez,Patulul,40683,20278,49.8 %,20405,50.2 %,11343,27.9 %,29340,72.1 %,7203,17.7 %
10,1015,Suchitepéquez,Santa Bárbara,26346,13318,50.6 %,13028,49.4 %,17172,65.2 %,9174,34.8 %,3553,13.5 %
10,1016,Suchitepéquez,San Juan Bautista,7826,3869,49.4 %,3957,50.6 %,3788,48.4 %,4038,51.6 %,652,8.3 %
10,1017,Suchitepéquez,Santo Tomás La Unión,11698,5605,47.9 %,6093,52.1 %,4365,37.3 %,7333,62.7 %,9357,80.0 %
10,1018,Suchitepéquez,Zunilito,8280,4133,49.9 %,4147,50.1 %,4457,53.8 %,3823,46.2 %,940,11.4 %
10,1019,Suchitepéquez,Pueblo Nuevo,11315,5528,48.9 %,5787,51.1 %,3404,30.1 %,7911,69.9 %,6551,57.9 %
10,1020,Suchitepéquez,Río Bravo,27606,13725,49.7 %,13881,50.3 %,15391,55.8 %,12215,44.2 %,3113,11.3 %
10,1021,Suchitepéquez,San José La Máquina,23062,11170,48.4 %,11892,51.6 %,4775,20.7 %,18287,79.3 %,5627,24.4 %
11,1101,Retalhuleu,Retalhuleu,90505,43862,48.5 %,46643,51.5 %,90505,100.0 %,0,0.0 %,2645,2.9 %
11,1102,Retalhuleu,San Sebastián,29167,14155,48.5 %,15012,51.5 %,9362,32.1 %,19805,67.9 %,12086,41.4 %
11,1103,Retalhuleu,Santa Cruz Muluá,13545,6714,49.6 %,6831,50.4 %,4674,34.5 %,8871,65.5 %,477,3.5 %
11,1104,Retalhuleu,San Martín Zapotitlán,12083,6017,49.8 %,6066,50.2 %,3751,31.0 %,8332,69.0 %,655,5.4 %
11,1105,Retalhuleu,San Felipe,24446,11820,48.4 %,12626,51.6 %,17360,71.0 %,7086,29.0 %,2358,9.6 %
11,1106,Retalhuleu,San Andrés Villa Seca,47820,23764,49.7 %,24056,50.3 %,11763,24.6 %,36057,75.4 %,12505,26.2 %
11,1107,Retalhuleu,Champerico,32815,16119,49.1 %,16696,50.9 %,9941,30.3 %,22874,69.7 %,4428,13.5 %
11,1108,Retalhuleu,Nuevo San Carlos,39565,19453,49.2 %,20112,50.8 %,22657,57.3 %,16908,42.7 %,832,2.1 %
11,1109,Retalhuleu,El Asintal,36882,17841,48.4 %,19041,51.6 %,17388,47.1 %,19494,52.9 %,13885,37.6 %
12,1201,San Marcos,San Marcos,47063,22256,47.3 %,24807,52.7 %,47063,100.0 %,0,0.0 %,1776,3.8 %
12,1202,San Marcos,San Pedro Sacatepéquez,79158,37710,47.6 %,41448,52.4 %,49589,62.6 %,29569,37.4 %,11478,14.5 %
12,1203,San Marcos,San Antonio Sacatepéquez,19100,9102,47.7 %,9998,52.3 %,1702,8.9 %,17398,91.1 %,7900,41.4 %
12,1204,San Marcos,Comitancillo,59489,28760,48.3 %,30729,51.7 %,9034,15.2 %,50455,84.8 %,59131,99.4 %
12,1205,San Marcos,San Miguel Ixtahuacán,47301,23014,48.7 %,24287,51.3 %,3376,7.1 %,43925,92.9 %,46515,98.3 %
12,1206,San Marcos,Concepción Tutuapa,68148,32557,47.8 %,35591,52.2 %,6006,8.8 %,62142,91.2 %,66371,97.4 %
12,1207,San Marcos,Tacaná,75788,37423,49.4 %,38365,50.6 %,8725,11.5 %,67063,88.5 %,7238,9.6 %
12,1208,San Marcos,Sibinal,15733,7849,49.9 %,7884,50.1 %,2517,16.0 %,13216,84.0 %,1230,7.8 %
12,1209,San Marcos,Tajumulco,50907,24262,47.7 %,26645,52.3 %,717,1.4 %,50190,98.6 %,48901,96.1 %
12,1210,San Marcos,Tejutla,38669,18810,48.6 %,19859,51.4 %,4437,11.5 %,34232,88.5 %,4393,11.4 %
12,1211,San Marcos,San Rafael Pie de la Cuesta,17139,8376,48.9 %,8763,51.1 %,3800,22.2 %,13339,77.8 %,333,1.9 %
12,1212,San Marcos,Nuevo Progreso,30067,14806,49.2 %,15261,50.8 %,2704,9.0 %,27363,91.0 %,571,1.9 %
12,1213,San Marcos,El Tumbador,44395,22073,49.7 %,22322,50.3 %,8856,19.9 %,35539,80.1 %,1436,3.2 %
12,1214,San Marcos,El Rodeo,17881,8884,49.7 %,8997,50.3 %,2356,13.2 %,15525,86.8 %,158,0.9 %
12,1215,San Marcos,Malacatán,92816,45371,48.9 %,47445,51.1 %,8689,9.4 %,84127,90.6 %,4314,4.6 %
12,1216,San Marcos,Catarina,30014,14783,49.3 %,15231,50.7 %,3407,11.4 %,26607,88.6 %,1027,3.4 %
12,1217,San Marcos,Ayutla,37049,17992,48.6 %,19057,51.4 %,23574,63.6 %,13475,36.4 %,691,1.9 %
12,1218,San Marcos,Ocós,10841,5338,49.2 %,5503,50.8 %,4417,40.7 %,6424,59.3 %,85,0.8 %
12,1219,San Marcos,San Pablo,48937,23541,48.1 %,25396,51.9 %,16768,34.3 %,32169,65.7 %,3124,6.4 %
12,1220,San Marcos,El Quetzal,23511,11544,49.1 %,11967,50.9 %,10513,44.7 %,12998,55.3 %,105,0.4 %
12,1221,San Marcos,La Reforma,17918,8832,49.3 %,9086,50.7 %,3850,21.5 %,14068,78.5 %,81,0.5 %
12,1222,San Marcos,Pajapita,21725,10578,48.7 %,11147,51.3 %,6817,31.4 %,14908,68.6 %,157,0.7 %
12,1223,San Marcos,Ixchiguán,22375,10544,47.1 %,11831,52.9 %,1527,6.8 %,20848,93.2 %,20196,90.3 %
12,1224,San Marcos,San José Ojetenam,19009,9388,49.4 %,9621,50.6 %,1689,8.9 %,17320,91.1 %,1636,8.6 %
12,1225,San Marcos,San Cristóbal Cucho,16619,7949,47.8 %,8670,52.2 %,5487,33.0 %,11132,67.0 %,1714,10.3 %
12,1226,San Marcos,Sipacapa,20178,9839,48.8 %,10339,51.2 %,1879,9.3 %,18299,90.7 %,18520,91.8 %
12,1227,San Marcos,Esquipulas Palo Gordo,12892,6217,48.2 %,6675,51.8 %,3952,30.7 %,8940,69.3 %,498,3.9 %
12,1228,San Marcos,Río Blanco,5318,2499,47.0 %,2819,53.0 %,1001,18.8 %,4317,81.2 %,1956,36.8 %
12,1229,San Marcos,San Lorenzo,13125,6340,48.3 %,6785,51.7 %,3660,27.9 %,9465,72.1 %,7701,58.7 %
12,1230,San Marcos,La Blanca,29112,14505,49.8 %,14607,50.2 %,13921,47.8 %,15191,52.2 %,185,0.6 %
13,1301,Huehuetenango,Huehuetenango,117818,55751,47.3 %,62067,52.7 %,117818,100.0 %,0,0.0 %,8933,7.6 %
13,1302,Huehuetenango,Chiantla,87447,42163,48.2 %,45284,51.8 %,7208,8.2 %,80239,91.8 %,8473,9.7 %
13,1303,Huehuetenango,Malacatancito,19155,9321,48.7 %,9834,51.3 %,835,4.4 %,18320,95.6 %,5781,30.2 %
13,1304,Huehuetenango,Cuilco,60395,28434,47.1 %,31961,52.9 %,2191,3.6 %,58204,96.4 %,11985,19.8 %
13,1305,Huehuetenango,Nentón,45679,22308,48.8 %,23371,51.2 %,18606,40.7 %,27073,59.3 %,35646,78.0 %
13,1306,Huehuetenango,San Pedro Necta,38510,18651,48.4 %,19859,51.6 %,4213,10.9 %,34297,89.1 %,31568,82.0 %
13,1307,Huehuetenango,Jacaltenango,37171,17364,46.7 %,19807,53.3 %,22533,60.6 %,14638,39.4 %,36376,97.9 %
13,1308,Huehuetenango,Soloma,49030,21982,44.8 %,27048,55.2 %,14166,28.9 %,34864,71.1 %,47119,96.1 %
13,1309,Huehuetenango,Ixtahuacán,44424,21484,48.4 %,22940,51.6 %,10875,24.5 %,33549,75.5 %,41673,93.8 %
13,1310,Huehuetenango,Santa Bárbara,33608,15960,47.5 %,17648,52.5 %,1133,3.4 %,32475,96.6 %,33290,99.1 %
13,1311,Huehuetenango,La Libertad,38234,18401,48.1 %,19833,51.9 %,6216,16.3 %,32018,83.7 %,6278,16.4 %
13,1312,Huehuetenango,La Democracia,55434,26658,48.1 %,28776,51.9 %,23146,41.8 %,32288,58.2 %,25488,46.0 %
13,1313,Huehuetenango,San Miguel Acatán,27128,12892,47.5 %,14236,52.5 %,5850,21.6 %,21278,78.4 %,27062,99.8 %
13,1314,Huehuetenango,San Rafael La Independencia,14149,6728,47.6 %,7421,52.4 %,1301,9.2 %,12848,90.8 %,14114,99.8 %
13,1315,Huehuetenango,Todos Santos Cuchumatán,30186,14064,46.6 %,16122,53.4 %,578,1.9 %,29608,98.1 %,26589,88.1 %
13,1316,Huehuetenango,San Juan Atitán,19418,8892,45.8 %,10526,54.2 %,4263,22.0 %,15155,78.0 %,19366,99.7 %
13,1317,Huehuetenango,Santa Eulalia,39025,18545,47.5 %,20480,52.5 %,3417,8.8 %,35608,91.2 %,38927,99.7 %
13,1318,Huehuetenango,San Mateo Ixtatán,43810,20930,47.8 %,22880,52.2 %,15090,34.4 %,28720,65.6 %,42860,97.8 %
13,1319,Huehuetenango,Colotenango,34834,16588,47.6 %,18246,52.4 %,5132,14.7 %,29702,85.3 %,34327,98.5 %
13,1320,Huehuetenango,San Sebastián Huehuetenango,32608,15638,48.0 %,16970,52.0 %,3517,10.8 %,29091,89.2 %,31257,95.9 %
13,1321,Huehuetenango,Tectitán,10830,5296,48.9 %,5534,51.1 %,888,8.2 %,9942,91.8 %,2093,19.3 %
13,1322,Huehuetenango,Concepción Huista,18915,8809,46.6 %,10106,53.4 %,7243,38.3 %,11672,61.7 %,17790,94.1 %
13,1323,Huehuetenango,San Juan Ixcoy,23204,10827,46.7 %,12377,53.3 %,2330,10.0 %,20874,90.0 %,22108,95.3 %
13,1324,Huehuetenango,San Antonio Huista,16697,8116,48.6 %,8581,51.4 %,6132,36.7 %,10565,63.3 %,4371,26.2 %
13,1325,Huehuetenango,San Sebastián Coatán,20905,9956,47.6 %,10949,52.4 %,989,4.7 %,19916,95.3 %,20864,99.8 %
13,1326,Huehuetenango,Barillas,100849,49736,49.3 %,51113,50.7 %,17166,17.0 %,83683,83.0 %,86423,85.7 %
13,1327,Huehuetenango,Aguacatán,49607,22542,45.4 %,27065,54.6 %,8084,16.3 %,41523,83.7 %,44037,88.8 %
13,1328,Huehuetenango,San Rafael Petzal,11271,5454,48.4 %,5817,51.6 %,5112,45.4 %,6159,54.6 %,11011,97.7 %
13,1329,Huehuetenango,San Gaspar Ixchil,8142,3846,47.2 %,4296,52.8 %,834,10.2 %,7308,89.8 %,8123,99.8 %
13,1330,Huehuetenango,Santiago Chimaltenango,10507,4881,46.5 %,5626,53.5 %,5841,55.6 %,4666,44.4 %,10470,99.6 %
13,1331,Huehuetenango,Santa Ana Huista,9413,4586,48.7 %,4827,51.3 %,237,2.5 %,9176,97.5 %,2834,30.1 %
13,1332,Huehuetenango,Unión Cantinil,15900,7343,46.2 %,8557,53.8 %,1514,9.5 %,14386,90.5 %,689,4.3 %
13,1333,Huehuetenango,Petatán,6366,2940,46.2 %,3426,53.8 %,2839,44.6 %,3527,55.4 %,5179,81.4 %
14,1401,Quiché,Santa Cruz del Quiché,78279,37168,47.5 %,41111,52.5 %,78279,100.0 %,0,0.0 %,65507,83.7 %
14,1402,Quiché,Chiché,29646,14319,48.3 %,15327,51.7 %,4565,15.4 %,25081,84.6 %,28788,97.1 %
14,1403,Quiché,Chinique,11382,5455,47.9 %,5927,52.1 %,2038,17.9 %,9344,82.1 %,9240,81.2 %
14,1404,Quiché,Zacualpa,32750,15499,47.3 %,17251,52.7 %,5603,17.1 %,27147,82.9 %,31319,95.6 %
14,1405,Quiché,Chajul,46658,22650,48.5 %,24008,51.5 %,24247,52.0 %,22411,48.0 %,42714,91.5 %
14,1406,Quiché,Chichicastenango,141567,67187,47.5 %,74380,52.5 %,71394,50.4 %,70173,49.6 %,140037,98.9 %
14,1407,Quiché,Patzité,6144,2884,46.9 %,3260,53.1 %,987,16.1 %,5157,83.9 %,6052,98.5 %
14,1408,Quiché,San Antonio Ilotenango,25590,12030,47.0 %,13560,53.0 %,4988,19.5 %,20602,80.5 %,25484,99.6 %
14,1409,Quiché,San Pedro Jocopilas,31950,15447,48.3 %,16503,51.7 %,1096,3.4 %,30854,96.6 %,30234,94.6 %
14,1410,Quiché,Cunén,41455,20111,48.5 %,21344,51.5 %,7903,19.1 %,33552,80.9 %,37719,91.0 %
14,1411,Quiché,San Juan Cotzal,31532,15327,48.6 %,16205,51.4 %,14032,44.5 %,17500,55.5 %,30416,96.5 %
14,1412,Quiché,Joyabaj,82369,37751,45.8 %,44618,54.2 %,15451,18.8 %,66918,81.2 %,75385,91.5 %
14,1413,Quiché,Nebaj,72686,33997,46.8 %,38689,53.2 %,31935,43.9 %,40751,56.1 %,68849,94.7 %
14,1414,Quiché,San Andrés Sajcabajá,24981,11762,47.1 %,13219,52.9 %,2816,11.3 %,22165,88.7 %,22269,89.1 %
14,1415,Quiché,Uspantán,65872,32548,49.4 %,33324,50.6 %,6664,10.1 %,59208,89.9 %,55061,83.6 %
14,1416,Quiché,Sacapulas,52620,25332,48.1 %,27288,51.9 %,12225,23.2 %,40395,76.8 %,50862,96.7 %
14,1417,Quiché,San Bartolomé Jocotenango,13568,6608,48.7 %,6960,51.3 %,2143,15.8 %,11425,84.2 %,13380,98.6 %
14,1418,Quiché,Canillá,12172,5802,47.7 %,6370,52.3 %,2489,20.4 %,9683,79.6 %,5600,46.0 %
14,1419,Quiché,Chicamán,39731,19403,48.8 %,20328,51.2 %,2920,7.3 %,36811,92.7 %,31194,78.5 %
14,1420,Quiché,Ixcán,99470,49845,50.1 %,49625,49.9 %,12710,12.8 %,86760,87.2 %,77312,77.7 %
14,1421,Quiché,Pachalum,8839,4222,47.8 %,4617,52.2 %,2084,23.6 %,6755,76.4 %,1383,15.6 %
15,1501,Baja Verapaz,Salamá,65275,31246,47.9 %,34029,52.1 %,65275,100.0 %,0,0.0 %,14795,22.7 %
15,1502,Baja Verapaz,San Miguel Chicaj,33121,15933,48.1 %,17188,51.9 %,7609,23.0 %,25512,77.0 %,30380,91.7 %
15,1503,Baja Verapaz,Rabinal,40797,19591,48.0 %,21206,52.0 %,15157,37.2 %,25640,62.8 %,33500,82.1 %
15,1504,Baja Verapaz,Cubulco,54869,26436,48.2 %,28433,51.8 %,10681,19.5 %,44188,80.5 %,40947,74.6 %
15,1505,Baja Verapaz,Granados,13595,6584,48.4 %,7011,51.6 %,1101,8.1 %,12494,91.9 %,1361,10.0 %
15,1506,Baja Verapaz,El Chol,9538,4490,47.1 %,5048,52.9 %,2027,21.3 %,7511,78.7 %,869,9.1 %
15,1507,Baja Verapaz,San Jerónimo,25459,12395,48.7 %,13064,51.3 %,10530,41.4 %,14929,58.6 %,4418,17.4 %
15,1508,Baja Verapaz,Purulhá,56822,28250,49.7 %,28572,50.3 %,7901,13.9 %,48921,86.1 %,54325,95.6 %
16,1601,Alta Verapaz,Cobán,212421,103927,48.9 %,108494,51.1 %,212047,99.8 %,374,0.2 %,182153,85.8 %
16,1602,Alta Verapaz,Santa Cruz Verapaz,32042,15722,49.1 %,16320,50.9 %,8630,26.9 %,23412,73.1 %,26059,81.3 %
16,1603,Alta Verapaz,San Cristóbal Verapaz,68819,34072,49.5 %,34747,50.5 %,20961,30.5 %,47858,69.5 %,61362,89.2 %
16,1604,Alta Verapaz,Tactic,38052,18331,48.2 %,19721,51.8 %,15213,40.0 %,22839,60.0 %,32595,85.7 %
16,1605,Alta Verapaz,Tamahú,19984,9930,49.7 %,10054,50.3 %,3910,19.6 %,16074,80.4 %,19629,98.2 %
16,1606,Alta Verapaz,Tucurú,43473,21736,50.0 %,21737,50.0 %,4064,9.3 %,39409,90.7 %,42568,97.9 %
16,1607,Alta Verapaz,Panzós,71846,36243,50.4 %,35603,49.6 %,22068,30.7 %,49778,69.3 %,70796,98.5 %
16,1608,Alta Verapaz,Senahú,91974,46017,50.0 %,45957,50.0 %,12084,13.1 %,79890,86.9 %,91001,98.9 %
16,1609,Alta Verapaz,San Pedro Carchá,235275,116267,49.4 %,119008,50.6 %,16353,7.0 %,218922,93.0 %,228320,97.0 %
16,1610,Alta Verapaz,San Juan Chamelco,57456,28048,48.8 %,29408,51.2 %,13264,23.1 %,44192,76.9 %,55831,97.2 %
16,1611,Alta Verapaz,Lanquín,24099,12172,50.5 %,11927,49.5 %,2969,12.3 %,21130,87.7 %,23847,99.0 %
16,1612,Alta Verapaz,Cahabón,64911,32516,50.1 %,32395,49.9 %,3492,5.4 %,61419,94.6 %,64075,98.7 %
16,1613,Alta Verapaz,Chisec,84553,43042,50.9 %,41511,49.1 %,9884,11.7 %,74669,88.3 %,79016,93.5 %
16,1614,Alta Verapaz,Chahal,26644,13270,49.8 %,13374,50.2 %,4244,15.9 %,22400,84.1 %,25021,93.9 %
16,1615,Alta Verapaz,Fray Bartolomé de Las Casas,66141,32975,49.9 %,33166,50.1 %,3935,5.9 %,62206,94.1 %,59595,90.1 %
16,1616,Alta Verapaz,Santa Catalina La Tinta,40516,20135,49.7 %,20381,50.3 %,20552,50.7 %,19964,49.3 %,39101,96.5 %
16,1617,Alta Verapaz,Raxruhá,36832,18475,50.2 %,18357,49.8 %,6038,16.4 %,30794,83.6 %,30971,84.1 %
17,1701,Petén,Flores,38186,18823,49.3 %,19363,50.7 %,38186,100.0 %,0,0.0 %,2638,6.9 %
17,1702,Petén,San José,6989,3570,51.1 %,3419,48.9 %,1586,22.7 %,5403,77.3 %,2403,34.4 %
17,1703,Petén,San Benito,43841,21357,48.7 %,22484,51.3 %,34788,79.4 %,9053,20.6 %,3598,8.2 %
17,1704,Petén,San Andrés,32878,16934,51.5 %,15944,48.5 %,12516,38.1 %,20362,61.9 %,5578,17.0 %
17,1705,Petén,La Libertad,71939,36495,50.7 %,35444,49.3 %,23820,33.1 %,48119,66.9 %,15806,22.0 %
17,1706,Petén,San Francisco,15371,7718,50.2 %,7653,49.8 %,9298,60.5 %,6073,39.5 %,3438,22.4 %
17,1707,Petén,Santa Ana,21970,10879,49.5 %,11091,50.5 %,10612,48.3 %,11358,51.7 %,1568,7.1 %
17,1708,Petén,Dolores,26920,13416,49.8 %,13504,50.2 %,7595,28.2 %,19325,71.8 %,2594,9.6 %
17,1709,Petén,San Luis,67038,33303,49.7 %,33735,50.3 %,10316,15.4 %,56722,84.6 %,42082,62.8 %
17,1710,Petén,Sayaxché,93414,47076,50.4 %,46338,49.6 %,13780,14.8 %,79634,85.2 %,57769,61.8 %
17,1711,Petén,Melchor de Mencos,28238,14137,50.1 %,14101,49.9 %,14972,53.0 %,13266,47.0 %,918,3.3 %
17,1712,Petén,Poptún,52282,25667,49.1 %,26615,50.9 %,29130,55.7 %,23152,44.3 %,17896,34.2 %
17,1713,Petén,Las Cruces,32715,16609,50.8 %,16106,49.2 %,10594,32.4 %,22121,67.6 %,7183,22.0 %
17,1714,Petén,El Chal,13819,6879,49.8 %,6940,50.2 %,3604,26.1 %,10215,73.9 %,3102,22.4 %
18,1801,Izabal,Puerto Barrios,100593,49144,48.9 %,51449,51.1 %,100593,100.0 %,0,0.0 %,7492,7.4 %
18,1802,Izabal,Lívingston,73492,36456,49.6 %,37036,50.4 %,17923,24.4 %,55569,75.6 %,41286,56.2 %
18,1803,Izabal,El Estor,73328,36947,50.4 %,36381,49.6 %,20489,27.9 %,52839,72.1 %,67369,91.9 %
18,1804,Izabal,Morales,100361,49191,49.0 %,51170,51.0 %,23855,23.8 %,76506,76.2 %,2643,2.6 %
18,1805,Izabal,Los Amates,60914,30121,49.4 %,30793,50.6 %,4793,7.9 %,56121,92.1 %,1142,1.9 %
19,1901,Zacapa,Zacapa,60424,29201,48.3 %,31223,51.7 %,60370,99.9 %,54,0.1 %,1485,2.5 %
19,1902,Zacapa,Estanzuela,9797,4759,48.6 %,5038,51.4 %,7941,81.1 %,1856,18.9 %,146,1.5 %
19,1903,Zacapa,Río Hondo,21434,10319,48.1 %,11115,51.9 %,6267,29.2 %,15167,70.8 %,221,1.0 %
19,1904,Zacapa,Gualán,45663,22471,49.2 %,23192,50.8 %,6430,14.1 %,39233,85.9 %,589,1.3 %
19,1905,Zacapa,Teculután,17602,8603,48.9 %,8999,51.1 %,5585,31.7 %,12017,68.3 %,220,1.2 %
19,1906,Zacapa,Usumatlán,12232,6034,49.3 %,6198,50.7 %,4363,35.7 %,7869,64.3 %,136,1.1 %
19,1907,Zacapa,Cabañas,13641,6808,49.9 %,6833,50.1 %,7322,53.7 %,6319,46.3 %,82,0.6 %
19,1908,Zacapa,San Diego,7235,3536,48.9 %,3699,51.1 %,706,9.8 %,6529,90.2 %,62,0.9 %
19,1909,Zacapa,La Unión,33572,16804,50.1 %,16768,49.9 %,2511,7.5 %,31061,92.5 %,2765,8.2 %
19,1910,Zacapa,Huité,11470,5743,50.1 %,5727,49.9 %,3287,28.7 %,8183,71.3 %,147,1.3 %
19,1911,Zacapa,San Jorge,12304,5961,48.4 %,6343,51.6 %,3703,30.1 %,8601,69.9 %,102,0.8 %
20,2001,Chiquimula,Chiquimula,111505,53300,47.8 %,58205,52.2 %,111505,100.0 %,0,0.0 %,1215,1.1 %
20,2002,Chiquimula,San José La Arada,8756,4193,47.9 %,4563,52.1 %,2844,32.5 %,5912,67.5 %,167,1.9 %
20,2003,Chiquimula,San Juan Ermita,16418,8101,49.3 %,8317,50.7 %,653,4.0 %,15765,96.0 %,5297,32.3 %
20,2004,Chiquimula,Jocotán,66379,32249,48.6 %,34130,51.4 %,8387,12.6 %,57992,87.4 %,53366,80.4 %
20,2005,Chiquimula,Camotán,56138,27808,49.5 %,28330,50.5 %,676,1.2 %,55462,98.8 %,36296,64.7 %
20,2006,Chiquimula,Olopa,27511,13325,48.4 %,14186,51.6 %,2486,9.0 %,25025,91.0 %,14293,52.0 %
20,2007,Chiquimula,Esquipulas,53556,25517,47.6 %,28039,52.4 %,18667,34.9 %,34889,65.1 %,1780,3.3 %
20,2008,Chiquimula,Concepción Las Minas,11693,5558,47.5 %,6135,52.5 %,1087,9.3 %,10606,90.7 %,62,0.5 %
20,2009,Chiquimula,Quezaltepeque,28075,13030,46.4 %,15045,53.6 %,2019,7.2 %,26056,92.8 %,252,0.9 %
20,2010,Chiquimula,San Jacinto,12619,6143,48.7 %,6476,51.3 %,915,7.3 %,11704,92.7 %,52,0.4 %
20,2011,Chiquimula,Ipala,22413,10686,47.7 %,11727,52.3 %,5932,26.5 %,16481,73.5 %,205,0.9 %
21,2101,Jalapa,Jalapa,159840,77140,48.3 %,82700,51.7 %,159840,100.0 %,0,0.0 %,80573,50.4 %
21,2102,Jalapa,San Pedro Pinula,61908,30545,49.3 %,31363,50.7 %,8933,14.4 %,52975,85.6 %,6581,10.6 %
21,2103,Jalapa,San Luis Jilotepeque,24679,11470,46.5 %,13209,53.5 %,11675,47.3 %,13004,52.7 %,16103,65.2 %
21,2104,Jalapa,San Manuel Chaparrón,8317,3865,46.5 %,4452,53.5 %,3347,40.2 %,4970,59.8 %,70,0.8 %
21,2105,Jalapa,San Carlos Alzatate,18977,9353,49.3 %,9624,50.7 %,8906,46.9 %,10071,53.1 %,17862,94.1 %
21,2106,Jalapa,Monjas,27354,13043,47.7 %,14311,52.3 %,13541,49.5 %,13813,50.5 %,794,2.9 %
21,2107,Jalapa,Mataquescuintla,41848,20455,48.9 %,21393,51.1 %,9833,23.5 %,32015,76.5 %,12959,31.0 %
22,2201,Jutiapa,Jutiapa,145880,71056,48.7 %,74824,51.3 %,145880,100.0 %,0,0.0 %,52374,35.9 %
22,2202,Jutiapa,El Progreso,22114,10399,47.0 %,11715,53.0 %,9504,43.0 %,12610,57.0 %,400,1.8 %
22,2203,Jutiapa,Santa Catarina Mita,28983,13546,46.7 %,15437,53.3 %,14520,50.1 %,14463,49.9 %,1661,5.7 %
22,2204,Jutiapa,Agua Blanca,16353,7810,47.8 %,8543,52.2 %,3897,23.8 %,12456,76.2 %,661,4.0 %
22,2205,Jutiapa,Asunción Mita,48297,23188,48.0 %,25109,52.0 %,20936,43.3 %,27361,56.7 %,1677,3.5 %
22,2206,Jutiapa,Yupiltepeque,17389,8612,49.5 %,8777,50.5 %,3016,17.3 %,14373,82.7 %,4060,23.3 %
22,2207,Jutiapa,Atescatempa,18402,8948,48.6 %,9454,51.4 %,9606,52.2 %,8796,47.8 %,697,3.8 %
22,2208,Jutiapa,Jerez,6309,3109,49.3 %,3200,50.7 %,3744,59.3 %,2565,40.7 %,241,3.8 %
22,2209,Jutiapa,El Adelanto,6500,3232,49.7 %,3268,50.3 %,2341,36.0 %,4159,64.0 %,815,12.5 %
22,2210,Jutiapa,Zapotitlán,9126,4551,49.9 %,4575,50.1 %,2118,23.2 %,7008,76.8 %,1670,18.3 %
22,2211,Jutiapa,Comapa,32207,15805,49.1 %,16402,50.9 %,4400,13.7 %,27807,86.3 %,4141,12.9 %
22,2212,Jutiapa,Jalpatagua,28832,14087,48.9 %,14745,51.1 %,10336,35.8 %,18496,64.2 %,2881,10.0 %
22,2213,Jutiapa,Conguaco,23452,11619,49.5 %,11833,50.5 %,2936,12.5 %,20516,87.5 %,11980,51.1 %
22,2214,Jutiapa,Moyuta,39781,19429,48.8 %,20352,51.2 %,6779,17.0 %,33002,83.0 %,7965,20.0 %
22,2215,Jutiapa,Pasaco,8854,4347,49.1 %,4507,50.9 %,1912,21.6 %,6942,78.4 %,72,0.8 %
22,2216,Jutiapa,San José Acatempa,13206,6351,48.1 %,6855,51.9 %,5285,40.0 %,7921,60.0 %,197,1.5 %
22,2217,Jutiapa,Quesada,22710,11174,49.2 %,11536,50.8 %,2544,11.2 %,20166,88.8 %,9412,41.4 %
